VK_Upper	VHC_L1_UpperSection	E
VK_Middle	VHC_L1_MiddleSection	E
VK_Lower	VHC_L1_LowerSection	E
VK2_Upper	VHC_L2_UpperSection	E
VK2_Middle	VHC_L2_MiddleSection	E
VK2_Lower	VHC_L2_LowerSection	E
VK3_Upper	VHC_L3_UpperSection	E
VK3_Middle	VHC_L3_MiddleSection	E
VK3_Lower	VHC_L3_LowerSection	E
HK_Upper	HHC_L1_UpperSection	E
HK_Middle	HHC_L1_MiddleSection	E
HK_Lower	HHC_L1_LowerSection	E
HK2_Upper	HHC_L2_UpperSection	E
HK2_Middle	HHC_L2_MiddleSection	E
HK2_Lower	HHC_L2_LowerSection	E
HK3_Upper	HHC_L3_UpperSection	E
HK3_Middle	HHC_L3_MiddleSection	E
HK3_Lower	HHC_L3_LowerSection	E
SS_Upper	SS_L1_UpperSection	E
SS_Middle	SS_L1_MiddleSection	E
SS_Lower	SS_L1_LowerSection	E
SS2_Upper	SS_L2_UpperSection	E
SS2_Middle	SS_L2_MiddleSection	E
SS2_Lower	SS_L2_LowerSection	E
SS3_Upper	SS_L3_UpperSection	E
SS3_Middle	SS_L3_MiddleSection	E
SS3_Lower	SS_L3_LowerSection	E
SY_Upper	SY_L1_UpperSection	E
SY_Middle	SY_L1_MiddleSection	E
SY_Lower	SY_L1_LowerSection	E
SY2_Upper	SY_L2_UpperSection	E
SY2_Middle	SY_L2_MiddleSection	E
SY2_Lower	SY_L2_LowerSection	E
SY3_Upper	SY_L3_UpperSection	E
SY3_Lower	SY_L3_LowerSection	E
SY3_Middle	SY_L3_MiddleSection	E
HANI_Upper	HAN_L1_UpperSection	N
HANI_Middl	HAN_L1_MiddleSection	N
HANI_Lower	HAN_L1_LowerSection	N
HANI2_Uppe	HAN_L2_UpperSection	N
HANI2_Midd	HAN_L2_MiddleSection	N
HANI2_Lowe	HAN_L2_LowerSection	N
HANI3_Lowe	HAN_L3_UpperSection	N
HANI3_Midd	HAN_L3_MiddleSection	N
HANI3_Uppe	HAN_L3_LowerSection	N
River_con1	RC_UpperSection	E
River_Stage1	RS_UpperSection	N
River_Bot1	RB_UpperSection	N
River_con2	RC_MiddleSection	E
River_Stage2	RS_MiddleSection	N
River_Bot2	RB_MiddleSection	N
River_con3	RC_LowerSection	E
River_Stage3	RS_LowerSection	N
River_Bot3	RB_LowerSection	N
v__ALPHA_BF.gw	Alpha_recession	N
v__CH_N2.rte	Manning's_Main_Channels	N
v__CH_N1.sub	Manning's_Tributary_Channels	N
v__CH_K2.rte	HC_Main_Channels	N
v__CN2.mgt______SUGC,BANA,UCOM,UIDU,URHD,URLD,URML	CN2_Farmlands	N
v__CDN.bsn	CDN	N
v__CN2.mgt______PAST,HAY,AGRL	CN2_Pasture	N
v__SDNCO.bsn	SDNCO	N
v__CN2.mgt______FRST	CN2_Forests	N
v__NPERCO.bsn	NPERCO	N
r__SOL_CBN().sol______FRST	CarbonContent_Forests	N
v__CH_K1.sub	HC_Tributary_Channels	N
r__SOL_CBN().sol______PAST,HAY,SUGC,BANA,AGRL,UCOM,UIDU,URHD,URLD,URML	CarbonContent_Pasture&Farmlands	N
Poros_L1	Porosity_L1	N
Poros_L2	Porosity_L2	N
Poros_L3	Porosity_L3	N
LongDis_L3	LD_L3	N
LongDis_L1	LD_L1	N
LongDis_L2	LD_L2	N
LongDis_Vratio	LD_Vertical_Ratio	N
LongDis_Hraio	LD_Horizantal_Ratio	N
LongDis_Eff	LD_Efficiency	N
Bulk	Bulk_Density	N
Denit	Denitrification	N
GW_DELAY	Groundwater_delay	N
r__SOL_K().sol______FRST	Top_Soil_SHK	N
v__CANMX.hru______FRST	Forest_Canopy_Storage	N
r__SOL_AWC().sol______FRST	AWC_Forests	N
v__v__CN2.mgt______LN2985,LN21205	CN2_SuspectableSoil	N
r__SOL_AWC().sol______LN2985,LN21205,Mj81228	AWC_SuspectableSoil	N
r__SOL_K().sol______LN2985,LN21205	SHK_SuspectableSoil	N
r__SOL_AWC().sol______Mp191153,LN11221,Gh11263,Mp181273	AWC_UpperSection	N
r__SOL_AWC().sol______LN11221,Gh11263,Mp181273	AWC_LowerSectionMiddleSection	N